#############
#...#.......#
#.*.#.......#
#...#.......#
#...#...#...#
#...#...#...#
#...#...#...#
#...#...#...#
#.......#...#
#.......#...#
#.......#...#
#########...#
#############