#############
#...#.......#
#.*.#...#...#
#...#...#...#
#...#...#...#
#...#...#...#
#...#...#...#
#...#...#...#
#.......#...#
##########e##