###########
#*..#.#.#.#
###.#######
#.#.......#
#######.#.#
#.#.#.....#
#####.#.#.#
#.#.#.....#
#######.###
#.#.#.#...#
#########e#
