###########
#*..#.#.#.#
###.#######
#.#.....#.#
###.#.#.###
#.#.#.....#
###.#####.#
#...#.#...#
#.#######.#
#.#.#.#.#.#
#########e#