###########
#*........#
#.#.#.#.#.#
#.........#
#.#.#.#.#.#
#.........#
#.#.#.#.#.#
#.........#
###.#.###.#
#.#...#.#.#
#########e#