###########
#*........#
#.#.#.#.#.#
#.........#
#.#.#.#.###
#.....#.#.#
###.#.#.###
#.#.......#
#####.#.#.#
#.......#.#
#########e#