###################
#.................#
#.................#
#.................#
#.......*.........#
#.................#
#......###........#
#......###........#
#.................#
###################